20 97 97 97 97 97 97 97 97 97 97 97 97 97 97 97 97 97 97 22 0 0 0 0 0 0 0 0 0 0
62 40 40 40 40 40 40 24 40 40 40 40 40 40 40 40 40 40 40 43 0 0 0 0 0 0 0 0 0 0
40 40 24 40 96 98 40 62 40 40 100 40 96 22 40 20 97 98 40 43 0 0 0 0 0 0 0 0 0 0
40 40 62 40 40 40 40 40 100 40 40 100 40 43 40 62 40 40 40 43 0 0 0 0 0 0 0 0 0 0
24 40 40 24 40 100 40 40 40 100 40 40 40 62 40 40 20 98 40 43 0 0 0 0 0 0 0 0 0 0
43 40 40 62 40 40 100 100 40 40 100 40 100 40 40 96 60 40 40 43 0 0 0 0 0 0 0 0 0 0
43 40 40 40 40 100 40 40 40 24 40 40 40 40 100 40 40 100 40 62 0 0 0 0 0 0 0 0 0 0
43 97 98 40 100 40 40 24 40 62 40 40 100 40 40 40 24 40 40 40 0 0 0 0 0 0 0 0 0 0
43 40 40 40 40 40 40 43 40 40 100 40 40 24 40 96 43 40 40 40 0 0 0 0 0 0 0 0 0 0
43 40 24 40 96 97 97 60 40 40 40 24 40 100 40 40 43 100 40 24 0 0 0 0 0 0 0 0 0 0
43 40 62 40 40 40 40 40 24 40 40 100 40 40 100 40 62 40 40 43 0 0 0 0 0 0 0 0 0 0
43 40 40 96 97 97 98 40 43 98 40 40 40 100 40 40 40 24 40 43 0 0 0 0 0 0 0 0 0 0
43 40 40 40 40 62 40 40 43 40 40 100 40 40 40 100 40 43 40 43 0 0 0 0 0 0 0 0 0 0
43 100 40 96 98 40 40 40 62 40 100 40 96 98 40 40 96 60 40 43 0 0 0 0 0 0 0 0 0 0
43 40 40 40 40 40 100 40 40 40 40 40 40 40 100 40 40 40 40 43 0 0 0 0 0 0 0 0 0 0
58 97 97 97 97 97 97 97 97 97 97 97 97 97 97 97 97 97 97 60 0 0 0 0 0 0 0 0 0 0
0 0 0 0 0 0 0 0 0 0 0 0 0 0 0 0 0 0 0 0 0 0 0 0 0 0 0 0 0 0
0 0 0 0 0 0 0 0 0 0 0 0 0 0 0 0 0 0 0 0 0 0 0 0 0 0 0 0 0 0
0 0 0 0 0 0 0 0 0 0 0 0 0 0 0 0 0 0 0 0 0 0 0 0 0 0 0 0 0 0
0 0 0 0 0 0 0 0 0 0 0 0 0 0 0 0 0 0 0 0 0 0 0 0 0 0 0 0 0 0
