20 97 97 97 97 97 97 134 97 97 97 97 97 97 97 97 97 97 97 97 97 97 97 97 97 97 97 97 97 97 97 97 97 97 97 97 97 97 97 97 97 97 97 97 97 97 97 97 97 97 97 97 97 97 97 97 97 97 97 97 97 97 97 97 97 97 97 97 97 97 97 97 97 97 97 97 97 97 97 97 97 97 97 97 97 97 97 97 97 97 97 97 97 97 97 97 97 97 97 22
43 40 40 40 40 40 40 40 43 40 40 40 40 40 40 40 40 40 40 40 40 40 40 40 40 40 40 40 40 40 40 40 40 40 40 40 40 43 40 40 40 40 40 40 40 40 40 40 40 40 40 40 40 40 40 40 40 40 40 40 40 40 40 40 40 40 40 40 40 43 40 40 40 40 40 40 40 40 40 40 40 40 40 40 40 40 40 40 40 40 40 40 40 40 43 40 40 40 40 43
43 40 24 40 96 97 98 40 43 40 40 40 40 40 40 40 40 40 40 20 97 97 97 97 97 22 40 40 40 40 20 97 22 40 40 40 40 62 40 20 98 40 40 96 22 40 40 96 97 97 22 40 40 96 97 97 98 40 40 40 40 40 40 40 40 20 97 22 40 43 40 96 97 97 97 97 97 22 40 96 97 97 98 40 40 40 40 40 20 97 97 97 22 40 43 40 20 97 97 41
62 40 62 40 40 40 40 40 43 40 40 96 97 97 97 97 97 97 97 60 40 40 40 40 40 58 97 97 97 97 41 40 43 40 40 40 40 40 40 43 40 40 40 40 43 40 40 40 40 40 43 40 40 40 40 40 40 40 20 97 97 97 97 22 40 43 40 43 40 43 40 40 40 40 40 40 40 43 40 40 40 40 40 40 20 97 97 97 60 40 40 40 43 40 43 40 43 40 40 43
40 40 40 40 40 24 40 40 43 40 40 40 40 40 40 40 40 40 40 40 40 20 97 98 40 40 40 40 40 40 43 40 58 97 97 97 97 22 40 43 40 96 22 40 58 97 97 97 22 40 58 22 40 40 40 40 40 40 43 40 40 40 40 43 40 58 97 60 40 62 40 96 97 97 97 22 40 43 40 40 40 40 20 97 60 40 40 40 40 40 24 40 43 40 43 40 43 40 40 43
40 40 40 40 40 58 97 97 60 40 40 40 40 40 40 40 40 40 40 40 40 43 40 40 40 40 40 20 22 40 43 40 40 40 40 40 40 43 40 40 40 40 43 40 40 40 40 40 43 40 40 43 40 96 97 97 97 97 60 40 40 40 40 43 40 40 40 40 40 40 40 40 40 40 40 43 40 43 40 96 97 97 60 40 40 40 40 40 40 40 43 40 43 40 43 40 58 22 40 43
24 40 40 24 40 40 40 40 40 40 96 97 97 97 97 22 40 96 97 97 97 97 97 22 40 24 40 58 60 40 58 97 97 97 97 22 40 43 40 24 40 40 58 97 22 40 24 40 43 40 40 43 40 40 40 40 40 40 40 40 24 40 40 58 22 40 20 97 97 97 97 97 22 40 40 43 40 43 40 40 40 40 40 40 97 97 97 97 22 40 43 40 43 40 43 40 40 43 40 43
43 40 40 43 40 40 40 40 40 40 40 40 40 40 40 43 40 40 40 40 40 40 40 62 40 43 40 40 40 40 40 40 40 40 40 43 40 43 40 43 40 40 40 40 43 40 43 40 43 40 40 58 97 97 97 97 97 97 22 40 58 22 40 40 43 40 43 40 40 40 40 40 43 40 20 60 40 62 40 40 40 40 40 40 40 40 40 40 43 40 43 40 39 97 59 98 40 43 40 134
43 40 40 62 40 40 96 97 97 97 97 97 97 97 97 60 40 40 20 21 21 22 40 40 40 43 40 40 96 97 97 97 97 97 97 60 40 43 40 58 97 22 40 20 60 40 43 40 43 40 40 40 40 40 40 40 40 40 43 40 40 43 40 40 43 40 58 97 97 22 40 40 43 40 43 40 40 40 40 96 97 97 97 22 40 40 40 40 43 40 43 40 43 40 40 40 40 43 40 134
43 40 40 40 40 40 40 43 40 40 40 40 40 40 40 40 40 40 58 59 59 60 40 40 40 43 40 40 40 40 40 40 40 40 40 40 40 43 40 40 40 43 40 43 40 40 43 40 39 97 97 97 97 97 97 97 98 40 43 40 40 43 40 40 43 40 40 40 40 43 40 20 60 40 43 40 40 40 40 40 40 40 40 58 97 97 22 40 43 40 43 40 43 40 96 97 97 40 97 22
39 97 98 40 40 40 40 43 40 40 40 40 40 40 40 40 40 40 40 40 40 40 40 24 40 43 40 40 24 40 24 40 40 40 40 40 40 43 40 40 40 43 40 43 40 40 43 40 43 40 40 40 40 40 40 40 40 40 43 40 40 43 40 40 58 97 97 22 40 43 40 43 40 40 43 40 40 24 40 40 40 40 40 40 40 40 43 40 58 97 59 59 60 40 40 40 40 43 40 43
43 40 40 40 40 40 40 43 40 40 20 97 97 97 97 97 97 97 97 21 97 97 97 60 40 43 40 40 43 40 43 40 40 40 40 24 40 43 40 20 97 60 40 58 22 40 62 40 43 40 40 20 97 97 97 97 22 40 43 40 40 43 40 40 40 40 40 43 40 43 40 43 40 40 43 40 40 43 40 96 97 97 97 22 40 40 43 40 40 40 40 43 40 40 20 98 40 43 40 43
43 40 40 24 40 40 40 40 40 40 43 40 40 40 40 40 40 40 40 43 40 40 40 40 40 43 40 40 43 40 43 40 20 97 97 41 40 43 40 43 40 40 40 40 43 40 40 40 43 40 40 43 40 40 40 40 43 40 43 40 40 58 97 97 22 40 40 43 40 43 40 43 40 40 43 40 40 43 40 40 40 40 40 58 22 40 58 97 97 97 97 41 40 40 43 40 40 43 40 43
43 40 40 43 40 96 97 97 97 97 60 40 40 24 40 20 97 97 97 60 40 40 40 40 40 43 40 40 43 40 43 40 43 40 40 62 40 43 40 62 40 20 22 40 58 97 97 97 60 40 40 43 40 96 97 97 60 40 43 40 40 40 40 40 43 40 40 43 40 43 40 43 40 40 43 40 20 60 40 40 40 40 40 40 43 40 40 40 40 43 40 58 22 40 43 40 20 60 40 43
43 40 40 43 40 40 40 40 40 40 40 40 40 43 40 43 40 40 40 40 40 40 20 97 97 60 40 40 58 59 60 40 43 40 40 40 40 43 40 40 40 39 41 40 40 40 40 40 40 40 40 43 40 40 40 40 40 40 43 40 40 20 22 40 43 40 40 43 40 43 40 58 97 97 41 40 43 40 40 20 97 97 22 40 43 40 40 24 40 43 40 40 58 59 60 40 43 40 40 43
43 40 40 58 97 97 97 97 98 40 40 40 40 43 40 62 40 40 40 24 40 40 43 40 40 40 40 40 40 40 40 40 43 40 40 20 97 60 40 24 40 58 60 40 20 97 97 97 97 97 97 41 40 96 97 97 98 40 43 40 40 39 41 40 43 40 40 43 40 43 40 40 40 40 43 40 43 40 40 43 40 40 43 40 43 40 40 43 40 43 40 40 40 40 40 40 43 40 40 43
43 40 40 40 40 40 40 40 40 40 20 97 97 60 40 40 40 40 40 43 40 40 43 40 40 20 97 97 97 97 97 97 60 40 40 43 40 40 40 43 40 40 40 40 43 40 40 40 40 40 40 43 40 40 40 40 40 40 43 40 40 39 41 40 43 40 40 43 40 43 40 40 40 40 43 40 43 40 40 43 40 20 60 40 43 40 40 43 40 43 40 40 20 21 21 21 41 40 40 43
39 97 98 40 40 24 40 40 96 97 60 40 40 40 40 96 97 97 97 59 97 97 60 40 40 43 40 40 40 40 40 40 40 40 96 60 40 24 40 58 98 40 40 96 60 40 96 97 97 97 97 60 40 96 97 97 97 97 60 40 40 39 41 40 58 98 40 43 40 58 97 97 98 40 43 40 58 98 40 62 40 43 40 40 58 97 97 60 40 58 98 40 58 59 59 59 60 40 40 43
43 40 40 40 40 43 40 40 40 40 40 40 40 40 40 40 40 40 40 40 40 40 40 40 40 43 40 40 40 40 40 40 40 40 40 40 40 43 40 40 40 40 40 40 40 40 40 40 40 40 40 40 40 40 40 40 40 40 40 40 40 58 60 40 40 40 40 43 40 40 40 40 40 40 43 40 40 40 40 40 40 43 40 40 40 40 40 40 40 40 40 40 40 40 40 40 40 40 40 43
58 97 97 97 97 97 97 97 97 97 97 97 97 97 97 97 97 97 97 97 97 97 97 97 97 97 97 97 97 97 97 97 97 97 97 97 97 97 97 97 97 97 97 97 97 97 97 97 97 97 97 97 97 97 97 97 97 97 97 97 97 97 97 97 97 97 97 97 97 97 97 97 97 97 97 97 59 97 97 97 97 59 97 97 97 97 97 97 97 97 97 97 97 97 97 97 97 97 97 60
